1111111111
1CCCC1PCC1
1CCEC1CCC1
111C111C11
1CCCCCCCC1
1111111111