11111111
100C01P1
100E0101
10100101
10000001
11111111