11111111111
100001C0011
1CE00100011
11101110111
1000C0P0011
11111111111
