1111111111
100001C001
1CE0010001
1110111011
1000C0P001
1111111111